XXXXXXXXXXX
XXXX XXXXXX
XXXX      X
XXXX XXXXXX
XXXX XXXXXX
XXXX XXXXXX
XXXX XXXXXX
XXXX XXXXXX
XXXX XXXXXX
XXXX XXXXXX
XXXX XXXXXX
XXXXXXXXXXX